11111111111111111
1P0011E0000CC1111
10010000000C00101
100001111100C0101
11111111111111111
